Front	Back	Tag	Status
0	μηδέν	Clt1	Uploaded
1	ένας/μία/ένα	Clt1	Uploaded
2	δύο	Clt1	Uploaded
3	τρεις/τρεις/τρία	Clt1	Uploaded
4	τέσσερις/τέσσερις/τέσσερα	Clt1	Uploaded
5	πέντε	Clt1	Uploaded
6	έξι	Clt1	Uploaded
7	επτά / εφτά	Clt1	Uploaded
8	οκτώ / οχτώ	Clt1	Uploaded
9	εννέα / εννιά	Clt1	Uploaded
10	δέκα	Clt1	Uploaded
11	έντεκα	Clt1	Uploaded
12	δώδεκα	Clt1	Uploaded
20	είκοσι	Clt1	Uploaded
30	τριάντα	Clt1	Uploaded
40	σαράντα	Clt1	Uploaded
50	πενήντα	Clt1	Uploaded
60	εξήντα	Clt1	Uploaded
70	εβδομήντα	Clt1	Uploaded
80	ογδόντα	Clt1	Uploaded
90	ενενήντα	Clt1	Uploaded
100	εκατό(ν)	Clt1	Uploaded
200	διακόσια	Clt1	Uploaded
300	τριακόσια	Clt1	Uploaded
400	τετρακόσια	Clt1	Uploaded
500	πεντακόσια	Clt1	Uploaded
600	εξακόσια	Clt1	Uploaded
700	επτακόσια	Clt1	Uploaded
800	οκτακόσια	Clt1	Uploaded
900	εννιακόσια	Clt1	Uploaded
1000	χίλια	Clt1	Uploaded
2000	δύο χιλιάδες	Clt1	Uploaded
3000	τρεις χιλιάδες	Clt1	Uploaded
4000	τέσσερις χιλιάδες	Clt1	Uploaded
5000	πέντε χιλιάδες	Clt1	Uploaded
6000	έξι χιλιάδες	Clt1	Uploaded
7000	επτά χιλιάδες	Clt1	Uploaded
8000	οκτώ χιλιάδες	Clt1	Uploaded
9000	εννέα χιλιάδες	Clt1	Uploaded
10000	δέκα χιλιάδες	Clt1	Uploaded
The lesson	Το μάθημα	Clt1	Uploaded
Who / what	Ποιος / ποια / ποιο	Clt1	Uploaded
To be 	Είμαι	Clt1	Uploaded
I am called	Με λένε Σάββα 	Clt1	Uploaded
I am …	Είμαι ο Σάββας	Clt1	Uploaded
What is your name? 	Πώς σε λένε;	Clt1	Uploaded
To know	Ξέρω	Clt1	Uploaded
To understand	Καταλαβαίνω	Clt1	Uploaded
English	Τα αγγλικά	Clt1	Uploaded
Dutch	Τα ολλανδικά	Clt1	Uploaded
French	Τα γαλλικά	Clt1	Uploaded
German	Τα γερμανικά	Clt1	Uploaded
Spanish	Τα ισπανικά	Clt1	Uploaded
Italian	Τα ιταλικά	Clt1	Uploaded
Greek	Τα ελληνικά 	Clt1	Uploaded
How?	Πώς;	Clt1	Uploaded
Where?	Πού;	Clt1	Uploaded
To live	Μένω	Clt1	Uploaded
From	Από 	Clt1	Uploaded
From where are you? 	Από πού είσαι;	Clt1	Uploaded
Belgium	Το Βέλγιο	Clt1	Uploaded
Greece	Η Ελλάδα	Clt1	Uploaded
Spain	Η Ισπανία	Clt1	Uploaded
Italy	Η Ιταλία	Clt1	Uploaded
UK	Η Αγγλία	Clt1	Uploaded
France	Η Γαλλία	Clt1	Uploaded
Amerika	Η Αμερική	Clt1	Uploaded
Germany	Η Γερμανία	Clt1	Uploaded
Netherlands	Η Ολλανδία	Clt1	Uploaded
Canada	Ο Καναδάς 	Clt1	Uploaded
To wait (for)	Περιμένω (τον Βαγγέλη/ την Μαρία/ το κορίτσι)	Clt1	Uploaded
To want	Θέλω	Clt1	Uploaded
What do you want? 	Τι Θέλεις;	Clt1	Uploaded
Hello (1 pers)	Γεια σου	Clt1	Uploaded
The book	Το βιβλίο	Clt1	Uploaded
The wine	Το κρασί	Clt1	Uploaded
The tea	Το τσάι	Clt1	Uploaded
The house	Το σπίτι 	Clt1	Uploaded
To say	Λέω	Clt1	Uploaded
To go	Πάω	Clt1	Uploaded
To have	Έχω	Clt1	Uploaded
To work	Δουλεύω	Clt1	Uploaded
To study	Σπουδάζω	Clt1	Uploaded
Good morning	Καλημέρα	Clt1	Uploaded
Good afernoon (only for saying hello)	Καλησπέρα	Clt1	Uploaded
Good night (only for saying goodbye)	Καληνύχτα	Clt1	Uploaded
Good afternoon (only for saying goodbye)	Καλό απόγευμα	Clt1	Uploaded
Good evening (only for saying goodbye)	Καλό βράδυ	Clt1	Uploaded
Good continuation/ See you later	Καλή συνέχεια	Clt1	Uploaded
Have a nice week (beginning of the week)	Καλή εβδομάδα	Clt1	Uploaded
Have a nice month (beginning of the month)	Καλό μήνα	Clt1	Uploaded
Hello (plural/polite)	Γεια σας, Δημήτρη και Δάφνη	Clt1	Uploaded
Hello (formal)	Χαίρετε	Clt1	Uploaded
Good / well	Καλά	Clt1	Uploaded
Very good	Πολύ Καλά	Clt1	Uploaded
Fantastic (literally = miracle)	Θαύμα	Clt1	Uploaded
Amazing	Μια χαρά	Clt1	Uploaded
So-so	έτσι κι έτσι	Clt1	Uploaded
Bad	Άσχημα	Clt1	Uploaded
Very bad	Πολύ άσχημα	Clt1	Uploaded
Horrible	Χάλια	Clt1	Uploaded
How are you? 	Τι κάνεις;	Clt1	Uploaded
Thanks	Ευχαριστώ	Clt1	Uploaded
The clock	Το ρολόι	Clt1	Uploaded
The time/ hour	Η ώρα	Clt1	Uploaded
The minute / the cent	Το λεπτό	Clt1	Uploaded
The second	Το δευτερόλεπτο	Clt1	Uploaded
The quarter	Το τέταρτο	Clt1	Uploaded
Half	Μισός/μισή/μισό	Clt1	Uploaded
And	Και / κι	Clt1	Uploaded
It is 10 to 2	Είναι δύο παρά δέκα	Clt1	Uploaded
The kilometers	Τα χιλιόμετρα	Clt1	Uploaded
To read	Διαβάζω	Clt1	Uploaded
Here	Εδώ	Clt1	Uploaded
Child	Το παιδί	Clt1	Uploaded
The telephone	Το τηλέφωνο	Clt1	Uploaded
The water	Το νερό	Clt1	Uploaded
The beach	Η θάλασσα	Clt1	Uploaded
The problem	Το πρόβλημα	Clt1	Uploaded
The student (M/F)	Ο φοιτητής / Η φοιτήτρια	Clt1	Uploaded
The chocoloate	Η σοκολάτα	Clt1	Uploaded
The ice cream	Το παγωτό	Clt1	Uploaded
The beer	Η μπύρα / μπίρα	Clt1	Uploaded
The souvlaki	Το σουβλάκι	Clt1	Uploaded
The yoghurt	Το γιαούρτι	Clt1	Uploaded
Τhe airport	Το αεροδρόμιο	Clt1	Uploaded
I am at home with Julia.	Είμαι στο σπίτι με την Τζούλια.	Clt1	Uploaded
The ouzo	Το ούζο	Clt1	Uploaded
The frappe	Ο φραπές	Clt1	Uploaded
The baklava	Ο μπακλαβάς	Clt1	Uploaded
The moussaka	Ο μουσακάς	Clt1	Uploaded
The tzatziki	Το τζατζίκι	Clt1	Uploaded
The kefte	Ο κεφτές	Clt1	Uploaded
Pastry filled with feta (bladerdeeg)	Η τυρόπιτα	Clt1	Uploaded
The orange juice	Ο χυμός πορτοκάλι	Clt1	Uploaded
Chinese	Τα κινέζικα	Clt1	Uploaded
It is 3 'o clock.	Είναι τρεις η ώρα	Clt1	Uploaded
The professor (M)	Ο καθηγητής	Clt1	Uploaded
The professor (F)	Η καθηγήτρια	Clt1	Uploaded
Sir	Κύριε	Clt1	Uploaded
Lady	Κύρια	Clt1	Uploaded
What do you do? (work)	Τι δουλειά κάνεις;	Clt1	Uploaded
The bank	Η τράπεζα	Clt1	Uploaded
The school	Το σχολείο	Clt1	Uploaded
The library	Η βιβλιοθήκη	Clt1	Uploaded
The cinema	Το σινεμά	Clt1	Uploaded
The doktor	Ο / η γιατρός	Clt1	Uploaded
The tavern	Η ταβέρνα	Clt1	Uploaded
The girl	Το κορίτσι	Clt1	Uploaded
The lemonade	Η λεμονάδα	Clt1	Uploaded
The car (automobiel)	Το αυτοκίνητο	Clt1	Uploaded
The newspaper	Η εφημερίδα	Clt1	Uploaded
The mobile (phone)	Το κινητό	Clt1	Uploaded
To make / to cost	Κάνω	Clt1	Uploaded
To go	Πηγαίνω	Clt1	Uploaded
To read / to study	Διαβάζω	Clt1	Uploaded
Married (M/F)	Παντρεμένος / παντρεμένη	Clt1	Uploaded
Single / free (M/F)	Ελεύθερος / ελεύθερη	Clt1	Uploaded
Separated (M/F)	Χωρισμένος / χωρισμένη	Clt1	Uploaded
Widow(er)	Χήρος / χήρα	Clt1	Uploaded
The boy(friend)	Ο φίλος	Clt1	Uploaded
The girl(friend)	Η φίλη	Clt1	Uploaded
The woman	Η γυναίκα	Clt1	Uploaded
The man	Ο άντρας	Clt1	Uploaded
The father	Ο πατέρας	Clt1	Uploaded
The mother	Η μητέρα	Clt1	Uploaded
The brother	Ο αδερφός / αδελφός	Clt1	Uploaded
The sister	Η αδερφή / αδελφή	Clt1	Uploaded
The daugher	Η κόρη	Clt1	Uploaded
The son	Ο γιος	Clt1	Uploaded
Now	Τώρα	Clt1	Uploaded
But	Αλλά	Clt1	Uploaded
The grandfather	Ο παππούς	Clt1	Uploaded
The grandmother	Η γιαγιά	Clt1	Uploaded
Welcome	Καλώς όρισες	Clt1	Uploaded
Ready	Έτοιμος / έτοιμη / έτοιμο	Clt1	Uploaded
Well / then / right / so	Λοιπόν	Clt1	Uploaded
The taxi	Το ταξί	Clt1	Uploaded
Please	Παρακαλώ	Clt1	Uploaded
Close	Κοντά	Clt1	Uploaded
The airplane	Το αεροπλάνο	Clt1	Uploaded
There	Εκεί	Clt1	Uploaded
Today	σήμερα	Clt1	Uploaded
The shop	Το μαγαζί	Clt1	Uploaded
The balcony	Το μπαλκόνι	Clt1	Uploaded
The cat	Η γάτα	Clt1	Uploaded
I like … (singular)	Μου αρέσει	Clt1	Uploaded
Beautiful	Όμορφος / Όμορφη / Όμορφο	Clt1	Uploaded
Ugly	Άσκημος / άσκημη / άσκημο Άσχημος / άσχημη / άσχημο	Clt1	Uploaded
Big	Μεγάλος / μεγάλη / μεγάλο	Clt1	Uploaded
Small	Μικρός / μικρή / μικρό	Clt1	Uploaded
Good (adj)	Καλός / καλή / καλό	Clt1	Uploaded
How long? 	Πόσο καιρό;	Clt1	Uploaded
The year	Ο χρόνος	Clt1	Uploaded
Bravo	Μπράβο	Clt1	Uploaded
What time is it? 	Τι ώρα είναι;	Clt1	Uploaded
First	Πρώτο	Clt1	Uploaded
After(wards)	Μετά	Clt1	Uploaded
Far	Μακριά	Clt1	Uploaded
Right	Δεξιά	Clt1	Uploaded
Left	Αριστερά	Clt1	Uploaded
Maybe…? (soften the question)	Μήπως ...;	Clt1	Uploaded
Foreigner (M/F)	Ξένος / ξένη	Clt1	Uploaded
The hotel	Το ξενοδοχείο	Clt1	Uploaded
Of course	Βεβαίως	Clt1	Uploaded
The salad	Η σαλάτα	Clt1	Uploaded
The bus	Το λεωφορείο	Clt1	Uploaded
Nothing	Δεν τίποτα	Clt1	Uploaded
Something (only in question)	Τίποτα	Clt1	Uploaded
Something (not in question)	Κάτι	Clt1	Uploaded
How much does it cost?	Πόσο κάνει ...;	Clt1	Uploaded
The music	Η μουσική	Clt1	Uploaded
Here you go	Ορίστε	Clt1	Uploaded
The account	Ο λογαριασμός	Clt1	Uploaded
The kiosk	Το περίπτερο	Clt1	Uploaded
The seller (kiosk)	Ο περιπτεράς	Clt1	Uploaded
To buy	Αγοράζω	Clt1	Uploaded
To pay	Πληρώνω	Clt1	Uploaded
The money	Τα λεφτά	Clt1	Uploaded
The change	Τα ρέστα	Clt1	Uploaded
The small money (change)	Τα ψιλά	Clt1	Uploaded
The magazine	Το περιοδικό	Clt1	Uploaded
The chewing gum (originates from local Greek product)	Η μαστίχα	Clt1	Uploaded
The postage stamp	Το γραμματόσημο	Clt1	Uploaded
The card	Η κάρτα	Clt1	Uploaded
The cigar	Το τσιγάρο	Clt1	Uploaded
The pack of cigarettes	Ένα πακέτο τσιγάρα	Clt1	Uploaded
The matchbox	Κουτί σπίρτα	Clt1	Uploaded
The condom	Το προφυλακτικό 	Clt1	Uploaded
The map	Ο χάρτης	Clt1	Uploaded
The paper tissues	Τα χαρτομάντηλα	Clt1	Uploaded
Open	Ανοιχτός	Clt1	Uploaded
Closed	Κλειστός	Clt1	Uploaded
The pencil	Το μολύβι	Clt1	Uploaded
I don't think so.	Δεν νομίζω	Clt1	Uploaded
Why / because	Γιατί	Clt1	Uploaded
Bye / adios	Αντίο	Clt1	Uploaded
1 Euro	Ένα ευρώ	Clt1	Uploaded
Something else? 	Τίποτα άλλο;	Clt1	Uploaded
I wish you well	Να 'στε καλά	Clt1	Uploaded
Yes (formal yes)	Μάλιστα	Clt1	Uploaded
The bread	Το ψωμί	Clt1	Uploaded
The juice	Ο χυμός	Clt1	Uploaded
The croissant	Το κρουασάν	Clt1	Uploaded
The sandwish	Το σάντουιτς	Clt1	Uploaded
The chewing gum (cannot use it for Masticha)	Η τσίχλα	Clt1	Uploaded
The black bread	Το μαύρο ψωμί	Clt1	Uploaded
The country bread (boerenbrood)	Το χωριάτικο ψωμί	Clt1	Uploaded
The orangade / fanta	Η πορτοκαλάδα	Clt1	Uploaded
The tv	Η τηλεόραση	Clt1	Uploaded
The doll	Η κούκλα	Clt1	Uploaded
The island	Το νησί	Clt1	Uploaded
The snow	Το χιόνι	Clt1	Uploaded
The flower	Το λουλούδι	Clt1	Uploaded
The family	Η οικογένεια	Clt1	Uploaded
The class	Η τάξη	Clt1	Uploaded
The wallet	Το πορτοφόλι	Clt1	Uploaded
The food	Το φαγητό	Clt1	Uploaded
The bill please	Λογαριασμό παρακαλώ	Clt1	Uploaded
The street	Ο δρόμος	Clt1	Uploaded
The bakery	Ο φούρνος	Clt1	Uploaded
The street (for names)	Η οδός	Clt1	Uploaded
The hospital	Το νοσοκομείο	Clt1	Uploaded
The museum	Το μουσείο	Clt1	Uploaded
The cafe	Το καφενείο	Clt1	Uploaded
The restaurant	Το εστιατόριο	Clt1	Uploaded
The pharmacy	Το φαρμακείο	Clt1	Uploaded
The university	Το πανεπιστήμιο	Clt1	Uploaded
The workplace	Η δουλειά	Clt1	Uploaded
The office	Το γραφείο	Clt1	Uploaded
The post office	Το ταχυδρομείο	Clt1	Uploaded
Straight	Ευθεία	Clt1	Uploaded
The week	Η εβδομάδα	Clt1	Uploaded
Monday	Η Δευτέρα	Clt1	Uploaded
Tuesday	Η Τρίτη	Clt1	Uploaded
Wednesday	Η Τετάρτη	Clt1	Uploaded
Thursday	Η Πέμπτη	Clt1	Uploaded
Friday	Η Παρασκευή	Clt1	Uploaded
Saturday	Το Σάββατο	Clt1	Uploaded
Sunday	Η Κυριακή	Clt1	Uploaded
The weekend	Το σαββατοκύριακο	Clt1	Uploaded
How is it called in Greek? 	Πώς το λένε αυτό στα ελληνικά;	Clt1	Uploaded
The table	Το τραπέζι	Clt1	Uploaded
The chair	Η καρέκλα	Clt1	Uploaded
The passport	Το διαβατήριο	Clt1	Uploaded
The page	Η σελίδα	Clt1	Uploaded
The coca cola	Η κόκα-κόλα	Clt1	Uploaded
The milk	Το γάλα	Clt1	Uploaded
The chicken	Το κοτόπουλο	Clt1	Uploaded
The pizza	Η πίτσα	Clt1	Uploaded
The pasta	Η πάστα	Clt1	Uploaded
The spinach pie	Η σπανακόπιτα	Clt1	Uploaded
The butter	Το βούτυρο	Clt1	Uploaded
The banana	Η μπανάνα	Clt1	Uploaded
The turkey	Η γαλοπούλα	Clt1	Uploaded
The egg	Το αυγό	Clt1	Uploaded
The square	Η πλατεία	Clt1	Uploaded
The parcel	Το δέμα	Clt1	Uploaded
The bathroom	Το μπάνιο	Clt1	Uploaded
The day	Η μέρα	Clt1	Uploaded
The glass	Το ποτήρι	Clt1	Uploaded
The dish	Το πιάτο	Clt1	Uploaded
The room	Το δωμάτιο	Clt1	Uploaded
I like … (plural)	Μου αρέσουν τα βιβλία	Clt1	Uploaded
The cinema	Ο κινηματογράφος	Clt1	Uploaded
The month	Ο μήνας	Clt1	Uploaded
With	Με	Clt1	Uploaded
Or	Ή	Clt1	Uploaded
The attitude / The stop (bus, metro, …) (derived from the word to stand)	Η στάση	Clt1	Uploaded
The stadium	Το στάδιο	Clt1	Uploaded
The ticket	Το εισιτήριο	Clt1	Uploaded
The kitchen	Η κουζίνα	Clt1	Uploaded
The knife	Το μαχαίρι	Clt1	Uploaded
The fork	Το πιρούνι	Clt1	Uploaded
The spoon	Το κουτάλι	Clt1	Uploaded
The window	Το παράθυρο	Clt1	Uploaded
The apartment	Το διαμέρισμα	Clt1	Uploaded
The dog	Ο σκύλος	Clt1	Uploaded
The biscuit	Το μπισκότο	Clt1	Uploaded
My telephone number is …	Το τηλέφωνό μου είναι ...	Clt1	Uploaded
Expensive	Ακριβός / ακριβή / ακριβό	Clt1	Uploaded
The city	Η πόλη	Clt1	Uploaded
I learn Greek	Μαθαίνω ελληνικά	Clt1	Uploaded
How old are you? 	Πόσων χρονών είσαι;	Clt1	Uploaded
Is the bank open? 	Είναι ανοιχτή η τράπεζα;	Clt1	Uploaded
Who pays the bill? 	Ποιος πληρώνει τον λογαριασμό;	Clt1	Uploaded
Is the taxi free? 	Είναι το ταξί ελεύθερο;	Clt1	Uploaded
To learn	Μαθαίνω	Clt1	Uploaded
The weather	Ο καιρός	Clt1	Uploaded
The aspirin	Η ασπιρίνη 	Clt1	Uploaded
I / me	Εγώ	Clt1	Uploaded
You (singular)	Εσύ	Clt1	Uploaded
He / she / it	Αυτός / αυτή / αυτό	Clt1	Uploaded
We	Εμείς	Clt1	Uploaded
You (plural)	Εσείς	Clt1	Uploaded
They (M/F/O)	Αυτοί / αυτές / αυτά	Clt1	Uploaded
The orange	Το πορτοκάλι	Clt1	Uploaded
The apple	Το μήλο	Clt1	Uploaded
The pear	Το αχλάδι 	Clt1	Uploaded
The plum	Το δαμάσκηνο	Clt1	Uploaded
The cherry	Το κεράσι	Clt1	Uploaded
The coconut	Η καρύδα	Clt1	Uploaded
The grape	Το σταφύλι	Clt1	Uploaded
The clothes	Τα ρούχα	Clt1	Uploaded
What is he/she wearing?	Τι φοράει;	Clt1	Uploaded
The suit	Το κοστούμι	Clt1	Uploaded
The handkerchief	Το μαντήλι	Clt1	Uploaded
The scarf	Το κασκόλ	Clt1	Uploaded
The sweater	Το πουλόβερ	Clt1	Uploaded
The pants	Το παντελόνι	Clt1	Uploaded
The bag	Η τσάντα	Clt1	Uploaded
The hat	Το καπέλο	Clt1	Uploaded
The glove	Το γάντι	Clt1	Uploaded
The pair of gloves	Το ζευγάρι γάντια	Clt1	Uploaded
The belt	Η ζώνη	Clt1	Uploaded
The sock	Η κάλτσα	Clt1	Uploaded
A pair of socks	Ένα ζευγάρι κάλτσες	Clt1	Uploaded
The T-shirt	Το μπλουζάκι	Clt1	Uploaded
The boot / boots	Η μπότα / μπότες	Clt1	Uploaded
The shirt (hemd)	Το πουκάμισο	Clt1	Uploaded
The shoe	Το παπούτσι	Clt1	Uploaded
A pair of shoes	Ένα ζευγάρι παπούτσια	Clt1	Uploaded
The jacket (short coat)	Το μπουφάν	Clt1	Uploaded
The glasses	Τα γυαλιά	Clt1	Uploaded
The skirt	Η φούστα	Clt1	Uploaded
The dress	Το φόρεμα	Clt1	Uploaded
The coat (long jacket)	Το παλτό	Clt1	Uploaded
The tie	Η γραβάτα	Clt1	Uploaded
The jacket (suit jacket)	Το σακάκι	Clt1	Uploaded
The button	Το κουμπί	Clt1	Uploaded
The vest (suit jacket without sleeves)	Το γιλέκο	Clt1	Uploaded
The cardigan	Η ζακέτα	Clt1	Uploaded
The blouse	Η μπλούζα	Clt1	Uploaded
The tank top	Το φανελάκι	Clt1	Uploaded
The underwear	Τα εσώρουχα	Clt1	Uploaded
A pair of house slippers	Ένα ζευγάρι παντόφλες	Clt1	Uploaded
A pair of sandals	Ένα ζευγάρι πέδιλα	Clt1	Uploaded
The cap (muts)	Ο σκούφος	Clt1	Uploaded
The shorts	Το σορτς	Clt1	Uploaded
The tights	Το καλσόν	Clt1	Uploaded
Single room	Μονόκλινο	Clt1	Uploaded
Double room	Δίκλινο	Clt1	Uploaded
Triple room	Τρίκλινο	Clt1	Uploaded
The bed	Το κρεβάτι	Clt1	Uploaded
The refrigerator	Το ψυγείο	Clt1	Uploaded
The shower	Το ντους	Clt1	Uploaded
The breakfast	Το πρωινό	Clt1	Uploaded
The view	Η θέα	Clt1	Uploaded
Does it have a sea view?	Έχει θέα στη θάλασσα;	Clt1	Uploaded
The floor (verdieping)	Ο όροφος	Clt1	Uploaded
The elevator	Το ασανσέρ	Clt1	Uploaded
First	Πρώτος / πρώτη / πρώτο	Clt1	Uploaded
Second	Δεύτερος / δεύτερη / δεύτερο	Clt1	Uploaded
Third	Τρίτος / τρίτη / τρίτο	Clt1	Uploaded
Fourth	Τέταρτος / τέταρτη / τέταρτο	Clt1	Uploaded
Fifth	Πέμπτος / πέμπτη / πέμπτο	Clt1	Uploaded
Sixth	Έκτος / έκτη / έκτο	Clt1	Uploaded
Seventh	Έβδομος / έβδομη / έβδομο	Clt1	Uploaded
The key	Το κλειδί	Clt1	Uploaded
Yellow	Κίτρινος /κίτρινη / κίτρινο	Clt1	Uploaded
Orange	Πορτοκαλί	Clt1	Uploaded
Red	Κόκκινος / κόκκινη / κόκκινο	Clt1	Uploaded
Green	Πράσινος / πράσινη / πράσινο	Clt1	Uploaded
Dark blue	Μπλε	Clt1	Uploaded
Light blue	Γαλάζιο / γαλάζια / γαλάζιο	Clt1	Uploaded
Pink	Ροζ	Clt1	Uploaded
Beige	Μπεζ	Clt1	Uploaded
Purple	Μοβ	Clt1	Uploaded
White	Άσπρος / άσπρη / άσπρο	Clt1	Uploaded
Black	Μαύρος / μαύρη / μαύρο	Clt1	Uploaded
Brown	Καφέ	Clt1	Uploaded
Grey	Γκρι	Clt1	Uploaded
The shopkeeper (bediende)	Ο υπάλληλος	Clt1	Uploaded
The price	Η τιμή	Clt1	Uploaded
At a good price	Σε καλή τιμή	Clt1	Uploaded
The number	Το νούμερο	Clt1	Uploaded
Young / new	Νέος / νέα / νέο	Clt1	Uploaded
Funny	Αστείος / αστεία / αστείο	Clt1	Uploaded
Expresses future tense (I will do … / I will be …)	Θα (θα κάνω / θα είμαι)	Clt1	Uploaded
I eat	Τρώω	Clt1	Uploaded
I cook = I make food	Μαγειρεύω = κάνω φαγητό	Clt1	Uploaded
I take a walk	Κάνω βόλτα	Clt1	Uploaded
Sports	Σπορ	Clt1	Uploaded
I watch TV	Βλέπω τηλεόραση	Clt1	Uploaded
The color	Το χρώμα	Clt1	Uploaded
Every /  each	Κάθε	Clt1	Uploaded
I see	Βλέπω	Clt1	Uploaded
Beautiful / good / nice	Ωραίος / ωραία / ωραίο	Clt1	Uploaded
The actor / actress	Ο / η ηθοποιός	Clt1	Uploaded
Do you see him / her?	Τον / την βλέπεις;	Clt1	Uploaded
I drink	Πίνω	Clt1	Uploaded
I write	Γράφω	Clt1	Uploaded
Τhe morning	Το πρωί	Clt1	Uploaded
The exercise	Η άσκηση	Clt1	Uploaded
For how long? 	Για πόσον καιρό;	Clt1	Uploaded
Warm	Ζεστός / ζεστή / ζεστό	Clt1	Uploaded
Of course (confirmation)	Φυσικά	Clt1	Uploaded
I give	Δίνω	Clt1	Uploaded
But you are young	Μα είστε νέα	Clt1	Uploaded
I am looking for / I search for	Ψάχνω	Clt1	Uploaded
The National Bank	Η Εθνική τράπεζα	Clt1	Uploaded
The years (2 plural forms)	Τα χρόνια (οι χρόνοι - only for verb conjugations)	Clt1	Uploaded
I dance	Χορεύω	Clt1	Uploaded
The person / individual	Το άτομο	Clt1	Uploaded
The apartment building	Η πολυκατοικία	Clt1	Uploaded
On the ground floor	Στο ισόγειο	Clt1	Uploaded
I play (…)	Παίζω (κιθάρα / πιάνο / τάωλι / θέατρο / χαρτιά)	Clt1	Uploaded
Rich	Πλούσιος / πλούσια / πλούσιο	Clt1	Uploaded
Cold	Κρύος /κρύα / κρύο	Clt1	Uploaded
New	Καινούργιος /καινούργια / καινούργιο	Clt1	Uploaded
Cheap	Φτηνός / φτηνή /φτηνό	Clt1	Uploaded
Tall (for people/ buildings)	Ψηλός / ψηλή / ψηλό	Clt1	Uploaded
Short (only in lenght)	Κοντός / κοντή / κοντό	Clt1	Uploaded
Smart	Έξυπνος /έξυπνη /έξυπνο	Clt1	Uploaded
Delicious	Νόστιμος / νόστιμη / νόστιμο	Clt1	Uploaded
Ancient	Αρχαίος / αρχαία / αρχαίο	Clt1	Uploaded
Average 	Μέτριος / μέτρια / μέτριο	Clt1	Uploaded
From… to/ until	Από ... ως / μέχρι	Clt1	Uploaded
Is there a single room?	Έχει (ένα) μονόκλινο δωμάτιο;	Clt1	Uploaded
Does it have a shower or bathtub? 	Έχει ντους ή μπάνιο;	Clt1	Uploaded
From 8 to 10. 	Από τις 8 ως τις 10. / 8 με 10.	Clt1	Uploaded
The salt	Το αλάτι	Clt1	Uploaded
The pepper	Το πιπέρι	Clt1	Uploaded
Straight down (for directions)	Ευθεία κάτω	Clt1	Uploaded
To go up	Ανεβαίνω	Clt1	Uploaded
To go down	Κατεβαίνω	Clt1	Uploaded
To turn 	Στρίβω	Clt1	Uploaded
To go out(side)	Βγαίνω (έξω)	Clt1	Uploaded
To go in(side)	Μπαίνω (μέσα)	Clt1	Uploaded
To complain	Γκρινιάζω	Clt1	Uploaded
To make a stop (for bus)	Κάνω στάση	Clt1	Uploaded
Up	(ε)πάνω	Clt1	Uploaded
Down	Κάτω	Clt1	Uploaded
Below	Παρακάτω	Clt1	Uploaded
Exactly	Ακριβώς	Clt1	Uploaded
Opposite (in location)	Απέναντι	Clt1	Uploaded
Quickly	Γρήγορα	Clt1	Uploaded
Again	Πάλι	Clt1	Uploaded
Although / but	Όμως	Clt1	Uploaded
Voila / look here	Να > for ex: να ο Σαββας / να το βιβλίο	Clt1	Uploaded
The corner	Η γωνία	Clt1	Uploaded
The square	Το τετράγωνο	Clt1	Uploaded
The supermarket	Το σούπερ-μάρκετ	Clt1	Uploaded
Mr- / Mrs-	Κυρ- / κυρα-	Clt1	Uploaded
Pleased / happy with	Ευχαριστημένος / ευχαριστημένη / ευχαριστημένο	Clt1	Uploaded
Tired	Κουρασμένος / κουρασμένη / κουρασμένο	Clt1	Uploaded
Slower please	Πιο αργά, παρακαλώ	Clt1	Uploaded
The avenue	Η λεωφόρος	Clt1	Uploaded
The church	Η εκκλησία	Clt1	Uploaded
The theater	Το θέατρο	Clt1	Uploaded
Where does the bus stop?	Πού κάνει στάση το λεωφορείο;	Clt1	Uploaded
The gift	Το δώρο	Clt1	Uploaded
The boy	Το αγόρι	Clt1	Uploaded
Quick	Γρήγορος / γρήγορη / γρήγορο	Clt1	Uploaded
Fresh	Φρέσκος / φρέσκη / φρέσκο	Clt1	Uploaded
Dirty	Βρόμικος / βρόμικη / βρόμικο	Clt1	Uploaded
To take	Παίρνω	Clt1	Uploaded
White (synonym to άσπρο)	Λευκός / λευκή / λευκό certain standard expressions using one but not the other: λευκά είδη (linen), Λευκός Οίκος (the White House) άσπρο ψωμί; άσπρα μαλλιά (white hair, but is actually one's old age); λευκά μαλλιά (hair colour)	Clt1	Uploaded
Thick / fat	Χοντρός / χοντρή / χοντρό	Clt1	Uploaded
Slim / thin	Λεπτός / λεπτή / λεπτό	Clt1	Uploaded
Athletic	Αθλητικός / αθλητική / αθλητικό	Clt1	Uploaded
Summery	Καλοκαιρινός / καλοκαιρινή / καλοκαιρινό	Clt1	Uploaded
Evening-	Βραδινός / βραδινή / βραδινό	Clt1	Uploaded
Modern	Μοντέρνος / μοντέρνα / μοντέρνο	Clt1	Uploaded
Daily -	Καθημερινός / καθημερινή / καθημερινό	Clt1	Uploaded
Classic(al)	Κλασικός / κλασική / κλασικό	Clt1	Uploaded
Narrow	Στενός / στενή / στενό	Clt1	Uploaded
A giftcard	Η δωροκάρτα	Clt1	Uploaded
To put	Βάζω	Clt1	Uploaded
Correct	Σωστό	Clt1	Uploaded
Incorrect / wrong	Λάθος	Clt1	Uploaded
Old	Παλιός / παλιά / παλιό	Clt1	Uploaded
The painting / tableau	Ο πίνακας	Clt1	Uploaded
The pump / heel	Η γόβα	Clt1	Uploaded
To exist / to have	Υπάρχω	Clt1	Uploaded
The parkinglot	Το πάρκιγκ	Clt1	Uploaded
The dry cleaners	Το καθαριστήριο	Clt1	Uploaded
The plumber	Ο υδραυλικός	Clt1	Uploaded
The pizzeria	Η πιτσαρία	Clt1	Uploaded
The tearoom / pastry shop	Το ζαχαροπλαστείο	Clt1	Uploaded
Sorry	Συγνώμη	Clt1	Uploaded
A (Is there a … -  more broad then ένας/μια/ένα)	Κανένας / καμιά / κανένα	Clt1	Uploaded
Next (to)	Δίπλα	Clt1	Uploaded
The bookstore	Το βιβλιοπωλείο	Clt1	Uploaded
The electrician	Ο ηλεκτρολόγος	Clt1	Uploaded
The park 	Το πάρκο	Clt1	Uploaded
The florist	Το ανθοπωλείο	Clt1	Uploaded
The dress (synonym to φόρεμα)	Το φουστάνι	Clt1	Uploaded
The swimsuit	Το μαγιό	Clt1	Uploaded
The slipper	Η παντόφλα	Clt1	Uploaded
The sandal	Το πέδιλο	Clt1	Uploaded
I have class in a bit	Έχω μάθημα σε λίγο	Clt1	Uploaded
Go straight on Nikos street (the street of Nikos = gen).	Πηγαίνετε ευθεία στην οδό Νίκος.	Clt1	Uploaded
You see the pharmacy on the right. 	Βλέπετε το φαρμακείο δεξιά.	Clt1	Uploaded
There, turn left. 	Εκεί στρίβετε αριστερά.	Clt1	Uploaded
Walk down the street Agia Sofia. 	Πηγαίνετε ευθεία κάτω την οδό Αγίας Σοφίας.	Clt1	Uploaded
On the Irini avenue. 	Στη λεωφόρο Ειρήνης.	Clt1	Uploaded
And accross is the square. 	Και απέναντι είναι η πλατεία.	Clt1	Uploaded
After 1 block you see a church. 	Μετά από ένα τετράγωνο βλέπετε μια εκκλησία.	Clt1	Uploaded
Two blocks down / further. 	Δύο τετράγωνα παρακάτω.	Clt1	Uploaded
Is there a bakery closeby? 	Υπάρχει κανένας φούρνος εδώ κοντά;	Clt1	Uploaded
Happy Birthday!	Χρόνια πολλά!	Clt1	Uploaded
May you become a 100!	Να τα εκατοστίσεις!	Clt1	Uploaded
The trip / journey	Το ταξίδι	Clt1	Uploaded
To travel	Ταξιδεύω	Clt1	Uploaded
The morning (until 13:00)	Το πρωί	Clt1	Uploaded
Midday / noon (13:00-15:00)	Το μεσημέρι	Clt1	Uploaded
The afternoon (15:00-20:00)	Το απόγευμα	Clt1	Uploaded
The evening (20:00-23:00)	Το βράδυ	Clt1	Uploaded
The night (after 23:00)	Η νύχτα	Clt1	Uploaded
Midnight (around 02:00)	Τα μεσάνυχτα	Clt1	Uploaded
Afternoon = p.m.	μμ = μετά το μεσημέρι	Clt1	Uploaded
Before noon = a.m.	πμ =  πριν το μεσημέρι	Clt1	Uploaded
It is 1 o'clock in the afternoon. 	Είναι μία το μεσημέρι.	Clt1	Uploaded
Before	Πριν	Clt1	Uploaded
Early	Νωρίς	Clt1	Uploaded
Late	Αργά	Clt1	Uploaded
The book of Petros. (gen)	Το βιβλίο του Πέτρου.	Clt1	Uploaded
Ο Αλέξανδρος genitive form	Ο Αλέξανδρος > του Αλέξανδρου	Clt1	Uploaded
Ο Βαγγέλης genitive form	Ο Βαγγέλης > του Βαγγέλη	Clt1	Uploaded
Ο Σάββας genitive form	Ο Σάββας > του Σάββα	Clt1	Uploaded
I am the girlfriend of Savvas. 	Είμαι το κορίτσι του Σάββα.	Clt1	Uploaded
Η Μαρία genitive form	Η Μαρία > της Μαρίας	Clt1	Uploaded
Η Νεφέλη genitive form	Η Νεφέλη > της Νεφέλης	Clt1	Uploaded
I am the boyfriend of Nefeli. 	Είμαι ο φίλος της Νεφέλης.	Clt1	Uploaded
To speak	Μιλάω / μιλώ	Clt1	Uploaded
I can	Μπορώ	Clt1	Uploaded
To arrive	Φτάνω	Clt1	Uploaded
To leave	Φεύγω	Clt1	Uploaded
To hear	Ακούω	Clt1	Uploaded
To be blamed	Φταίω	Clt1	Uploaded
The train is to be blaimed. It is the train's fault. 	Φταίει το τρένο.	Clt1	Uploaded
To love	Αγαπάω	Clt1	Uploaded
To be hungry	Πεινάω	Clt1	Uploaded
To be thursty	Διψάω	Clt1	Uploaded
To stop	Σταματάω	Clt1	Uploaded
To sing	Τραγουδάω	Clt1	Uploaded
To start / to set out	Ξεκινάω	Clt1	Uploaded
To pass (by)	Περνάω (από)	Clt1	Uploaded
To prefer	Προτιμάω	Clt1	Uploaded
To walk	Περπατάω	Clt1	Uploaded
To wake up	Ξυπνάω	Clt1	Uploaded
To be late (treuzelen)	Αργώ	Clt1	Uploaded
To agree	Συμφωνώ	Clt1	Uploaded
To worry	Ανησυχώ	Clt1	Uploaded
To forgive	Συγχωρώ	Clt1	Uploaded
To drive	Οδηγώ	Clt1	Uploaded
To call (by phone)	Τηλεφωνώ	Clt1	Uploaded
To live (life)	Ζω	Clt1	Uploaded
Forgive me. 	Με συγχωρείτε.	Clt1	Uploaded
To cry	Κλαίω	Clt1	Uploaded
The line (see metro line)	Η γραμμή	Clt1	Uploaded
Never	Ποτέ	Clt1	Uploaded
When	Πότε	Clt1	Uploaded
The station	Ο σταθμός	Clt1	Uploaded
Around	Γύρω 	Clt1	Uploaded
Around here.	Εδώ γύρω.	Clt1	Uploaded
To walk the dog / to let out the dog.	Βγάζω βόλτα το(ν) σκύλο.	Clt1	Uploaded
To take off / to put out(side)	Βγάζω (το πουλόβερ μου)	Clt1	Uploaded
The boat	Το πλοίο	Clt1	Uploaded
The train	Το τρένο	Clt1	Uploaded
The bicycle	Το ποδήλατο	Clt1	Uploaded
The (motor)bike	Η μηχανή	Clt1	Uploaded
On foot / by walking. 	Με τα πόδια.	Clt1	Uploaded
The feet. 	Τα πόδια.	Clt1	Uploaded
Bad, mean, evil	Κακός / κακή / κακό	Clt1	Uploaded
Difficult	Δύσκολος / δύσκολη / δύσκολο	Clt1	Uploaded
Easy	Εύκολος / εύκολη / εύκολο	Clt1	Uploaded
However	Πάντως	Clt1	Uploaded
A tab (used mainly for tab in browser)	Η καρτέλα	Clt1	Uploaded
Probably	Μάλλον	Clt1	Uploaded
Well-known	Γνωστός / γνωστή / γνωστό	Clt1	Uploaded
Very well-known brand. 	Πολύ γνωστή μάρκα.	Clt1	Uploaded
Always	Πάντα	Clt1	Uploaded
Usually	Συνήθως	Clt1	Uploaded
To go to sleep	Πάω για ύπνο	Clt1	Uploaded
The radio	Το ραδιόφωνο	Clt1	Uploaded
The news 	Τα νέα	Clt1	Uploaded
A time (een keer)	Η φορά	Clt1	Uploaded
Once	Μια φορά	Clt1	Uploaded
Rarely	Σπάνια	Clt1	Uploaded
The lunch	Το μεσημεριανό	Clt1	Uploaded
The dinner	Το βραδινό	Clt1	Uploaded
To go shopping	Πάω για ψώνια.	Clt1	Uploaded
Shopping (can be grocery shopping or clothes,…)	Τα ψώνια	Clt1	Uploaded
To do sports	Κάνω σπορ	Clt1	Uploaded
The company	Η παρέα	Clt1	Uploaded
To go around	Γυρίζω	Clt1	Uploaded
To smoke	Καπνίζω	Clt1	Uploaded
How do you spend your day? 	Πώς περνάς την ημέρα σου;	Clt1	Uploaded
Then	Τότε	Clt1	Uploaded
True 	Αλήθεια	Clt1	Uploaded
A name (typically refers to first name or full name, there is a specific word for last name)	Το όνομα	Clt1	Uploaded
Seriously	Σοβαρά	Clt1	Uploaded
Still	Ακόμα	Clt1	Uploaded
Out	Έξω	Clt1	Uploaded
In 	Μέσα	Clt1	Uploaded
The mister	Ο κύριος	Clt1	Uploaded
The lady	Η κυρία	Clt1	Uploaded
The cheese	Το τυρί	Clt1	Uploaded
The potato	Η πατάτα	Clt1	Uploaded
The tomato	Η ντομάτα	Clt1	Uploaded
Stuffed tomatoes	Οι γεμιστές ντομάτες	Clt1	Uploaded
The Greek salad	Η χωριάτικη σαλάτα	Clt1	Uploaded
The pastitsio	Το παστίτσιο	Clt1	Uploaded
The French fries	Οι τηγανητές πατάτες	Clt1	Uploaded
The lamb	Το αρνάκι	Clt1	Uploaded
Lamb fricassee = is a dish of pieces of meat or vegetables stewed in stock and served in a white sauce	Αρνάκι φρικασέ	Clt1	Uploaded
Nor / Neither … nor …	ούτε > δεν περιμένει ούτε την Αλίκη ούτε τον Κώστα.	Clt1	Uploaded
The guide / driver	Ο / η οδηγός	Clt1	Uploaded
The miss (literally little lady and considered old fashioned)	Δεσποινίς	Clt1	Uploaded
The uncle	Ο θείος	Clt1	Uploaded
The aunt	Η θεία	Clt1	Uploaded
When (toen)	Όταν	Clt1	Uploaded
Nikos is a very good friend of mine. 	Ο Νίκος είναι πολύ καλός φίλος μου.	Clt1	Uploaded
He lives alone. 	Μένει μόνος του.	Clt1	Uploaded
To make a phone call	Κάνω ένα τηλεφώνημα	Clt1	Uploaded
To be altruistic without any benefit for oneself	Το φιλότιμο	Clt1	Uploaded
The living room	Το σαλόνι	Clt1	Uploaded
The cup	Το φλυτζάνι	Clt1	Uploaded
The floor / ground	Το πάτωμα	Clt1	Uploaded
The animal	Το ζώο	Clt1	Uploaded
The shelf	Το ράφι	Clt1	Uploaded
The saucer / small plate	Το πιατάκι	Clt1	Uploaded
The cupboard	Η πιατοθήκη	Clt1	Uploaded
The cooking pot	Η κατσαρόλα	Clt1	Uploaded
The drawer	Το συρτάρι	Clt1	Uploaded
The little spoon	Το κουταλάκι	Clt1	Uploaded
The man / human	Ο άνθρωπος	Clt1	Uploaded
The zuchinis	Τα κολοκυθάκια	Clt1	Uploaded
The calamaris	Τα καλαμάρια	Clt1	Uploaded
The octopus	Το χταποδάκι	Clt1	Uploaded
To be hungry like a wolf	Πεινάω σαν λύκος	Clt1	Uploaded
The wolf	Ο λύκος	Clt1	Uploaded
The dialogue	Ο διάλογος	Clt1	Uploaded
The pasta dish	Η μακαρονάδα	Clt1	Uploaded
The address	Η διεύθυνση	Clt1	Uploaded
Not at all	Καθόλου > δεν πεινάω καθόλου / δεν υπάρχει καθόλου φαγητό	Clt1	Uploaded
To order …	Παραγγέλνω	Clt1	Uploaded
The lasagna 	Τα λαζάνια	Clt1	Uploaded
To send	Στέλνω	Clt1	Uploaded
The kiss / the kisses	Το φιλί / τα φιλιά	Clt1	Uploaded
The bird	Το πουλί	Clt1	Uploaded
The center	Το κέντρο	Clt1	Uploaded
Busses connected to grid directly similar to tram (in Athens)	Το τρόλεϊ	Clt1	Uploaded
Surely	Σίγουρα	Clt1	Uploaded
The same	Ο ίδιος	Clt1	Uploaded
The tram	Το τραμ	Clt1	Uploaded
How often does the metro run? Literally: every whenever?	Κάθε πότε περνάει το μετρό;	Clt1	Uploaded
I go by metro / I take the metro	Πάω με το μετρό / ...	Clt1	Uploaded
Next / following	Επόμενος / επόμενη / επόμενο	Clt1	Uploaded
How long for the next one? Will it be long untill the next one? Literraly: The next one will it still take a long time?	Αργεί το επόμενο; 	Clt1	Uploaded
I understood / I got it	Κατάλαβα	Clt1	Uploaded
Maybe, do you also have (tickets) for the metro?	Μήπως έχετε (εισιτήρια) και για το μετρό; 	Clt1	Uploaded
The travel agency	Το ταξιδιωτικό γραφείο	Clt1	Uploaded
A return ticket	Ένα εισιτήριο με επιστροφή	Clt1	Uploaded
With return (there and back)	Με επιστροφή	Clt1	Uploaded
How long does the plane take? 	Το αεροπλάνο πόση ώρα κάνει;	Clt1	Uploaded
… give me a minute …	... Μισό λεπτό ...	Clt1	Uploaded
There is no train from … to …	Δεν έχει τρένο από Αθήνα για Θεσσαλονίκη.	Clt1	Uploaded
The train leaves Thessaloniki at 8pm.	Το τρένο ξεκινάει από τη Θεσσαλονίκη στις 8 το βράδυ.	Clt1	Uploaded
About / around	Περίπου	Clt1	Uploaded
About / around an hour	Μία ώρα περίπου	Clt1	Uploaded
To cost	Κοστίζω	Clt1	Uploaded
The bottle	Το μπουκάλι	Clt1	Uploaded
The ad	Η αγγελία	Clt1	Uploaded
Tomorrow	αύριο	Clt1	Uploaded
The day after tomorrow	μεθαύριο	Clt1	Uploaded
Yesterday	(ε)χθές	Clt1	Uploaded
The day before yesterday	προχθές	Clt1	Uploaded
To set the table (2 synonyms)	Κάνω / στρώνω το τραπέζι	Clt1	Uploaded
The server (2 synonyms)	Ο σερβιτόρος / το γκαρσόν(ι)	Clt1	Uploaded
The bottle of wine	Το μπουκάλι κρασί	Clt1	Uploaded
To serve (the plate)	Σερβίρω (το πιάτο)	Clt1	Uploaded
The menu	Ο κατάλογος	Clt1	Uploaded
The port	Το λιμάνι	Clt1	Uploaded
There is no one. 	Δεν υπάρχει κανείς.	Clt1	Uploaded
Crazy	τρελή	Clt1	Uploaded
The door	Η πόρτα	Clt1	Uploaded
Easter	Το Πάσχα	Clt1	Uploaded
Christ has risen (happy easter)	Χριστός Ανέστη	Clt1	Uploaded
He has truly risen (happy easter)	Αληθώς Ανέστη	Clt1	Uploaded
The cook 	Ο μάγειρας	Clt1	Uploaded
The cutlery	Τα μαχαιροπίρουνα	Clt1	Uploaded
The spaghetti (long)	Τα μακαρόνια	Clt1	Uploaded
The pasta	Τα ζυμαρικά	Clt1	Uploaded
And what time does it arrive? 	Και τι ώρα φτάνει;	Clt1	Uploaded
The one-way ticket	Το απλό εισιτήριο	Clt1	Uploaded
The economy class ticket	Το εισιτήριο τουριστική θέση	Clt1	Uploaded
The first class ticket	Το εισιτήριο πρώτη θέση	Clt1	Uploaded
Cheaper	Πιο φτηνό	Clt1	Uploaded
How many do you want? 	Πόσα θέλετε;	Clt1	Uploaded
To run	Τρέχω	Clt1	Uploaded
Same	Ίδιος / ίδια / ίδιο	Clt1	Uploaded
That's enough / enough.	Φτάνει	Clt1	Uploaded
The season 	Η εποχή	Clt1	Uploaded
The winter	Ο χειμώνας	Clt1	Uploaded
The summer	Το καλοκαίρι	Clt1	Uploaded
The autumn	Το φθινόπωρο	Clt1	Uploaded
The spring	Η άνοιξη	Clt1	Uploaded
It's cold	Κάνει / έχει κρύο	Clt1	Uploaded
It's warm	Κάνει / έχει ζέστη	Clt1	Uploaded
What's the weather like?	Τι καιρό κάνει; Τι καιρό έχει;	Clt1	Uploaded
It is cool (fris)	Έχει δροσιά	Clt1	Uploaded
There is wind	Έχει αέρα	Clt1	Uploaded
There is sun	Έχει ήλιο	Clt1	Uploaded
It is cloudy	Έχει συννεφιά	Clt1	Uploaded
The weather is nice	Έχει ωραίο καιρό	Clt1	Uploaded
The weather is bad	Έχει άσχημο καιρό	Clt1	Uploaded
It is raining	Βρέχει	Clt1	Uploaded
It is snowing	Χιονίζει	Clt1	Uploaded
It is windy / het waait	Φυσάει	Clt1	Uploaded
Which season do you like? 	Ποια εποχή σου αρέσει;	Clt1	Uploaded
The days are longer. 	Οι μέρες είναι πιο μεγάλες.	Clt1	Uploaded
The cold	Το κρύο	Clt1	Uploaded
The warm / warmth	Η ζέστη	Clt1	Uploaded
The wind	Ο αέρας	Clt1	Uploaded
The sun	Ο ήλιος	Clt1	Uploaded
De bewolking 	Η συννεφιά	Clt1	Uploaded
The cloud	Το σύννεφο	Clt1	Uploaded
It is chilly / het is kil	Έχει ψύχρα	Clt1	Uploaded
θέλω present tense	θέλω θέλεις θέλει θέλουμε θέλετε θέλουν	Clt1	Uploaded
λέω present tense	λέω λές λέει λέμε λέτε λένε	Clt1	Uploaded
μιλάω present tense	μιλάω / μιλώ μιλάς μιλάει μιλάμε μιλάτε μιλάνε	Clt1	Uploaded
μπορώ present tense	μπορώ μπορείς μπορεί μπορούμε μπορείτε μπορούν	Clt1	Uploaded
The cucumber	Το αγγούρι	Clt1	Uploaded
The onion	Το κρεμμύδι	Clt1	Uploaded
I disagree	Δε συμφωνώ	Clt1	Uploaded
When is your birthday?	Πότε έχεις τα γενέθλιά σου;	Clt1	Uploaded
My birthday is in winter in January.	Έχω τα γενέθλιά μου το χειμώνα τον Ιανουάριο.	Clt1	Uploaded
Lies	τα ψέματα (ex: λέω ψέματα)	Clt1	Uploaded
The movie (3)	Η ταινία / το φιλμ / το έργο	Clt1	Uploaded
The wedding	Ο γάμος	Clt1	Uploaded
One more time	Άλλη μια φορά	Clt1	Uploaded
The leaf	Το φύλλο	Clt1	Uploaded
to fall	Πέφτω	Clt1	Uploaded
Football	Το ποδόσφαιρο	Clt1	Uploaded
Τhe program	Το πρόγραμμα	Clt1	Uploaded
To fly	Πετάω	Clt1	Uploaded
The market	Η λαϊκή	Clt1	Uploaded
The fruit	Τα φρούτα	Clt1	Uploaded
The vegetables	Τα λαχανικά	Clt1	Uploaded
The lettuce (krop sla)	Το μαρούλι	Clt1	Uploaded
The olive	Η ελιά	Clt1	Uploaded
The eggplant	Η μελιτζάνα	Clt1	Uploaded
To shake	Κουνάω	Clt1	Uploaded
The head (only for people)	Το κεφάλι	Clt1	Uploaded
Literally you don't tell me = tell mee / vertel het me eens	Δε μου λες. Δε μου λες, τι ώρα είναι;	Clt1	Uploaded
What do we have here (when summing up groceries,…) = literally we have and we say	έχουμε και λέμε	Clt1	Uploaded
The life (het leven)	Η ζωή	Clt1	Uploaded
Yes ofcourse! (Exclamation)	Αμέ!	Clt1	Uploaded
I can't believe it!	Δεν το πιστεύω!	Clt1	Uploaded
Often	Συχνά	Clt1	Uploaded
The gym	Το γυμναστήριο	Clt1	Uploaded
The baby	Το μωρό	Clt1	Uploaded
Sick	Άρρωστος / άρρωστη / άρρωστο	Clt1	Uploaded
In front	Μπροστά	Clt1	Uploaded
To answer	Απαντάω	Clt1	Uploaded
The traffic light	Το φανάρι	Clt1	Uploaded
To make an appointment	Κανονίζω	Clt1	Uploaded
How much of each?	Πόσο από το καθένα;	Clt1	Uploaded
Take (for ex at market saying take it)	Πάρε	Clt1	Uploaded
Great idea	Ωραία ιδέα	Clt1	Uploaded
For two years now.	Εδώ και δύο χρόνια.	Clt1	Uploaded
Αre we arranging somthing? 	Κανονίζουμε τίποτα;	Clt1	Uploaded
What would you want? 	Τι θα ήθελες;	Clt1	Uploaded
είμαι past tense	ήμουν ήσουν ήταν ήμασταν ήσασταν ήταν	Clt1	Uploaded
κάνω past tense	έκανα έκανες έκανε κάναμε κάνατε έκαναν / κάνανε	Clt1	Uploaded
βλέπω past tense	είδα είδες είδε είδαμε είδατε είδαν	Clt1	Uploaded
τρώω past tense	έφαγα έφαγες έφαγε φάγαμε φάγατε έφαγαν / φάγανε	Clt1	Uploaded
πηγαίνω / πάω past tense	πήγα πήγες πήγε πήγαμε πήγατε πήγαν	Clt1	Uploaded
γυρίζω past tense	γύρισα γύρισες γύρισε γυρίσαμε γυρίσατε γύρισαν / γυρίσανε	Clt1	Uploaded
Mine, yours, …	μου σου του / της / του μας σας τους / τους / τους	Clt1	Uploaded
The moon	Το φεγγάρι	Clt1	Uploaded
The dance	Ο χορός	Clt1	Uploaded
The retsina	Η ρετσίνα	Clt1	Uploaded
Firstly	Πρώτα (Πρώτα θα πάω στο φούρνο)	Clt1	Uploaded
The temple	Ο ναός	Clt1	Uploaded
All / everyone	Όλος / όλη / όλο (όλη την εβδομάδα)	Clt1	Uploaded
To sunbathe	κάνω ηλιοθεραπεία	Clt1	Uploaded
The song	Το τραγούδι	Clt1	Uploaded
To swim / to bathe	Κάνω μπάνιο	Clt1	Uploaded
From time to time	Κάπου-κάπου	Clt1	Uploaded
The moon is shining	Έχει φεγγάρι	Clt1	Uploaded
The monastery	Το μοναστήρι	Clt1	Uploaded
The small boat	Η βάρκα	Clt1	Uploaded
Simple / single	Απλός / απλή / απλό	Clt1	Uploaded
The return	Η επιστροφή	Clt1	Uploaded
The seat	Η θέση	Clt1	Uploaded
In January	Τον Ιανουάριο	Clt1	Uploaded
In February	Το(ν) Φεβρουάριο	Clt1	Uploaded
In March	Το(ν) Μάρτιο	Clt1	Uploaded
In April	Τον Απρίλιο	Clt1	Uploaded
In May	Το(ν) Μάιο	Clt1	Uploaded
In June	Τον Ιούνιο	Clt1	Uploaded
In July	Τον Ιούλιο	Clt1	Uploaded
In August	Τον Αύγουστο	Clt1	Uploaded
In September	Το(ν) Σεπτέμβριο	Clt1	Uploaded
In October	Τον Οκτώβριο	Clt1	Uploaded
In November	Το(ν) Νοέμβριο	Clt1	Uploaded
In December	Το(ν) Δεκέμβριο	Clt1	Uploaded
Last year	Πέρσι	Clt1	Uploaded
2 years ago	Πρόπερσι	Clt1	Uploaded
This year	Φέτος	Clt1	Uploaded
Last (last week,…)	Περασμένος / περασμένη / περασμένο	Clt1	Uploaded
I will be	Θα είμαι	Clt1	Uploaded
I will do	Θα κάνω	Clt1	Uploaded
I will see	θα δω θα δεις θα δει θα δούμε θα δείτε θα δουν	Clt1	Uploaded
I will eat	θα φάω θα φας θα φάει θα φάμε θα φάτε θα φάνε	Clt1	Uploaded
I will go	Θα πάω	Clt1	Uploaded
I will return	θα γυρίσω θα γυρίσεις θα γυρίσει θα γυρίσουμε θα γυρίσετε θα γυρίσουν	Clt1	Uploaded
Tonight	Απόψε	Clt1	Uploaded
Coming (next / following)	Ερχόμενος / ερχόμενη / ερχόμενο	Clt1	Uploaded
Next year	Του χρόνου	Clt1	Uploaded
In 2 years	Σε δύο χρόνια	Clt1	Uploaded
The holidays / vacation	Οι διακοπές	Clt1	Uploaded
I am going on vacation	Παώ διακοπές	Clt1	Uploaded
Together	Μαζί	Clt1	Uploaded
The computer	Ο υπολογιστής	Clt2	Uploaded
The repetition	Η επανάληψη	Clt2	Uploaded
To choose	Διαλέγω	Clt2	Uploaded
Are you rested? 	Ξεκουραστήκατε;	Clt2	Uploaded
Immediately	Αμέσως	Clt2	Uploaded
To sell	Πουλάω	Clt2	Uploaded
To ask for (something)	Ζητάω	Clt2	Uploaded
To greet	Χαιρετάω	Clt2	Uploaded
Some	Μερικός / μερική / μερικό	Clt2	Uploaded
Sometimes	Μερικές φορές	Clt2	Uploaded
To watch (a movie) / to take (a course)	Παρακολουθώ	Clt2	Uploaded
To study (blokken)	Μελετάω	Clt2	Uploaded
The work / the task	Η εργασία	Clt2	Uploaded
The cafetaria	Το κυλικείο	Clt2	Uploaded
The message / messages	Το μήνυμα / τα μηνύματα	Clt2	Uploaded
To prepare	Ετοιμάζω	Clt2	Uploaded
To make	Φτιάχνω	Clt2	Uploaded
To call	Καλώ	Clt2	Uploaded
The drink	Το ποτό	Clt2	Uploaded
Last	Τελευταίος / τελευταία / τελευταίο	Clt2	Uploaded
To find	Βρίσκω	Clt2	Uploaded
To ask	Ρωτάω	Clt2	Uploaded
That ...	Ότι	Clt2	Uploaded
The assistant	Ο / η βοηθός	Clt2	Uploaded
The lucky one	Ο τυχερός / η τυχερή	Clt2	Uploaded
The beginning	Η αρχή	Clt2	Uploaded
The parent	Ο γονέας / ο γονιός	Clt2	Uploaded
The garden	Ο κήπος	Clt2	Uploaded
The letter	Το γράμμα	Clt2	Uploaded
To open	Ανοίγω	Clt2	Uploaded
To close	Κλείνω	Clt2	Uploaded
The park	Το πάρκο	Clt2	Uploaded
The last name	Το επώνυμο	Clt2	Uploaded
Male nom + acc	Ο φίλος - το(ν) φίλο Ο άντρας - τον άντρα Ο μαθητής - το(ν) μαθητή Ο καφές - τον καφέ	Clt2	Uploaded
Female nom + acc	Η γυναίκα - τη(ν) γυναίκα Η φίλη - τη(ν) φίλη	Clt2	Uploaded
Which letters get τον and την?	Τον and την + κ,π,ξ,ψ (μπ,ντ,γκ)	Clt2	Uploaded
Neutral nom + acc	Το βιβλίο - Το βιβλίο Το παιδί - το παιδί Το μάθημα - το μάθημα	Clt2	Uploaded
Male nom singular + plural	Ο φίλος - οι φίλοι Ο άντρας - οι άντρες Ο μαθητής - οι μαθητές Ο καφές - οι καφέδες	Clt2	Uploaded
Female nom singular + plural	Η γυναίκα - οι γυναίκες Η φίλη - οι φίλες	Clt2	Uploaded
Neutral nom singular + plural	Το βιβλίο - τα βιβλία Το παιδί - τα παιδιά Το σπίτι - τα σπίτια Το μάθημα - τα μαθήματα Το γράμμα - τα γράμματα	Clt2	Uploaded
Lately	Τελευταία	Clt2	Uploaded
To work from home	Δουλεύω από το σπίτι	Clt2	Uploaded
To wash the dishes	Πλένω τα πιάτα	Clt2	Uploaded
To get up	Σηκώνομαι	Clt2	Uploaded
To wash yourself	Πλένομαι	Clt2	Uploaded
To pick up (the phone)	Σηκώνω	Clt2	Uploaded
To dress yourself	Ντύνομαι	Clt2	Uploaded
To put on make-up	Βάφομαι	Clt2	Uploaded
To shave yourself	Ξυρίζομαι	Clt2	Uploaded
To comb yourself	Χτενίζομαι	Clt2	Uploaded
To come	Έρχομαι	Clt2	Uploaded
To sit	Κάθομαι	Clt2	Uploaded
To think	Σκέφτομαι	Clt2	Uploaded
To feel	Αισθάνομαι	Clt2	Uploaded
To need	Χρειάζομαι	Clt2	Uploaded
To get tired / to tire yourself	Κουράζομαι	Clt2	Uploaded
To feel warm	Ζεσταίνομαι	Clt2	Uploaded
To sleep	Κοιμάμαι	Clt2	Uploaded
To remember	Θυμάμαι	Clt2	Uploaded
To be / feel sorry	Λυπάμαι	Clt2	Uploaded
To be afraid / to fear	Φοβάμαι	Clt2	Uploaded
To comb (a dog...)	Χτενίζω	Clt2	Uploaded
έρχομαι present tense	έρχομαι έρχεσαι έρχεται ερχόμαστε έρχεστε έρχονται	Clt2	Uploaded
κοιμάμαι present tense	κοιμάμαι κοιμάσαι κοιμάται κοιμόμαστε κοιμάστε κοιμούνται	Clt2	Uploaded
To begin work	Αρχίζω δουλειά	Clt2	Uploaded
The break (to take half an hour break)	Το διάλειμμα (κανώ μισή ώρα διάλειμμα)	Clt2	Uploaded
To finish work 	Σχολάω από τη δουλειά	Clt2	Uploaded
To finish	Σχολάω	Clt2	Uploaded
To ly down	Ξαπλώνω	Clt2	Uploaded
To meet	Συναντάω	Clt2	Uploaded
To come back	Επιστρέφω	Clt2	Uploaded
The rest (rust)	Η ξεκούραση	Clt2	Uploaded
All of us	Όλοι μας	Clt2	Uploaded
To forget	Ξεχνώ	Clt2	Uploaded
To rest yourself	Ξεκουράζομαι	Clt2	Uploaded
To be called (heten)	Λέγομαι	Clt2	Uploaded
To work (synonym to δουλεύω)	Εργάζομαι	Clt2	Uploaded
To work as an assistant	Εργάζομαι ως βοηθός	Clt2	Uploaded
The kilo	Το κιλό	Clt1	Uploaded
Maybe (not only for question)	Ίσως	Clt1	Uploaded
To sing a song	Λέω ένα τραγούδι	Clt1	Uploaded
Roasted	Ψητός / ψητή / ψητό	Clt1	Uploaded
The market	Η αγορά	Clt1	Uploaded
To go to the market / the shops	Πάω στην αγορά	Clt1	Uploaded
I will (not) see him	(δεν) θα τον δω	Clt1	Uploaded
The grill house	Η ψησταριά	Clt1	Uploaded
With	Με	Clt1	Uploaded
Come	Έλα	Clt1	Uploaded
Come with me	Έλα μαζί μου	Clt1	Uploaded
Dangerous	Επικίνδυνος / επικίνδυνη / επικίνδυνο	Clt1	Uploaded
A gram	Ένα γραμμάριο	Clt1	Uploaded
… that …	Που - when relaying feelings (except for φοβάμαι) Πως - for everything else + φοβάμαι	Clt2	Uploaded
I am afraid that ...	Φοβάμαι πως ...	Clt2	Uploaded
I am sorry that ...	Λυπάμαι που ...	Clt2	Uploaded
It is a pity / too bad that I was not there.	Κρίμα που δεν ήμουν έκει.	Clt2	Uploaded
I think that ...	Νομίζω πως ...	Clt2	Uploaded
For example	Για παράδειγμα	Clt2	Uploaded
The colleague	Ο / η συνάδελφος	Clt2	Uploaded
To laugh	Γελάω	Clt2	Uploaded
Who are you taking for a fool? Who are you trying to fool? 	Ποιον γελάτε;	Clt2	Uploaded
The doktor's office	Το ιατρείο	Clt2	Uploaded
My name is (verb)	Ονομάζομαι	Clt2	Uploaded
I do not + VERB + ever	Δεν + VERB + ποτέ Δεν βάφομαι ποτέ το πρωί	Clt2	Uploaded
I usually sleep early	Συνήθως κοιμάμαι νωρίς Κοιμάμαι συνήθως νωρίς	Clt2	Uploaded
Do not + VERB	Μη(ν) + VERB Μη λες τίποτα	Clt2	Uploaded
Do not ever tell lies	Μη λες ψέματα ποτέ Μη λες ποτέ ψέματα	Clt2	Uploaded
For hours	Με τις ώρες	Clt2	Uploaded
Get better / beterschap Literally: that it can pass	Περαστικά	Clt2	Uploaded
To hurt	Πονάω	Clt2	Uploaded
To tease / to annoy / to make sick or unwell / to harass	Πειράζω	Clt2	Uploaded
The stomach	Το στομάχι	Clt2	Uploaded
Strong / heavy	Δυνατός / δυνατή / δυνατό	Clt2	Uploaded
I am right 	Έχω δίκιο	Clt2	Uploaded
Actually ... / Now that you say ...	Εδώ που τα λέμε ...	Clt2	Uploaded
The throat 	Ο λαιμός	Clt2	Uploaded
The hart	Η καρδιά	Clt2	Uploaded
But how nice that ... (for giving compliments)	Μα τι ωραία που ...	Clt2	Uploaded
Don't tease me	Μη με πειράζεις	Clt2	Uploaded
Do not be like that / act like that	Μην κάνεις έτσι	Clt2	Uploaded
It's allright / don't worry	Δεν πειράζει	Clt2	Uploaded
Almost	Σχεδόν	Clt2	Uploaded
To get used to	Συνηθίζω	Clt2	Uploaded
To help	Βοηθάω	Clt2	Uploaded
To be ashamed / to be shy	Ντρέπομαι	Clt2	Uploaded
Who / which	Ποιο(ν) Who is always with ν  - ποιον  Which is without ν except for vowels and certain letters - ποιο(ν)	Clt2	Uploaded
This / deze / dit	Αυτός / ή / τό	Clt2	Uploaded
I like  - this man  - this woman - this song	μου αρέσει - αυτός ο άντρας - αυτή η γυναίκα - αυτό το τραγούδι	Clt2	Uploaded
The sweets	Τα γλυκά	Clt2	Uploaded
The medicine	Τα φάρμακα	Clt2	Uploaded
The hair	Τα μαλλιά	Clt2	Uploaded
The painter	Ο / η ζωγράφος	Clt2	Uploaded
The eye	Το μάτι	Clt2	Uploaded
The fever	Ο πυρετός	Clt2	Uploaded
The hairdresser (place)	Το κομμωτήριο	Clt2	Uploaded
The hairdresser (M/F)	Ο κομμωτής / η κομμώτρια	Clt2	Uploaded
To have a cold	Κρυώνω	Clt2	Uploaded
Strange / weird	Παράξενος / η / ο	Clt2	Uploaded
The truly bad luck	Η γκαντεμιά	Clt2	Uploaded
I overate	Παραέφαγα	Clt2	Uploaded
In a fast way	Τάκα-τάκα	Clt2	Uploaded
The memory	Η μνήμη	Clt2	Uploaded
The oil	Το λάδι	Clt2	Uploaded
That (not in close proximity)	Εκείνος ο ... Εκείνη η ... Εκείνο το ...	Clt2	Uploaded
All the time	Όλη την ώρα	Clt2	Uploaded
Day after day (every day)	Μέρα παρά μέρα	Clt2	Uploaded
To be found / to be situated	Βρίσκομαι	Clt2	Uploaded
Who do you mean?	Ποιον λες;	Clt2	Uploaded
To put the evil eye on someone - To remove the evil eye	Ματιάζω - Ξεματιάζω	Clt2	Uploaded
To exercise 	Γυμνάζομαι	Clt2	Uploaded
The thing / the things	Το πράγμα / τα πράγματα	Clt2	Uploaded
The piano	Το πιάνο	Clt2	Uploaded
To shout	Φωνάζω	Clt2	Uploaded
The journalist	Ο / η δημοσιογράφος	Clt2	Uploaded
The archeologist 	Ο / η αρχαιολόγος	Clt2	Uploaded
To spit	Φτύνω	Clt2	Uploaded
One who is in love	Ερωτευμένος / η / ο 	Clt2	Uploaded
The love (romantic)	Ο έρωτας	Clt2	Uploaded
The pool	Η πισίνα	Clt2	Uploaded
To swim	Κολυμπάω	Clt2	Uploaded
The fairy tale	Το παραμύθι	Clt2	Uploaded
I put on my clothes	Βάζω τα ρούχα μου	Clt2	Uploaded
The rule	Ο κανόνας	Clt2	Uploaded
Normal	Κανονικά	Clt2	Uploaded
Abnormal	Ανώμαλα	Clt2	Uploaded
Somewhere	Κάπου	Clt2	Uploaded
Sometimes	Κάποτε	Clt2	Uploaded
I hug	Αγκαλιάζω	Clt2	Uploaded
I look	Κοιτάζω	Clt2	Uploaded
The comedy	Η κωμωδία	Clt2	Uploaded
The beach	Η παραλία	Clt2	Uploaded
To be done	Τελειώνω	Clt2	Uploaded
Afterwards	Έπειτα	Clt2	Uploaded
To know / to learn	Γνωρίζω	Clt2	Uploaded
To lose (miss the plane)	Χάνω	Clt2	Uploaded
The castle	Το κάστρο	Clt2	Uploaded
Wonderful 	Υπέροχος / η / ο	Clt2	Uploaded
The exam (normally referred to in plural) 	Η εξέταση / οι εξετάσεις	Clt2	Uploaded
I started αρχίζω	Άρχισα	Clt2	Uploaded
I worked δουλεύω	Δούλεψα	Clt2	Uploaded
I bought αγόραζω	Αγόρασα	Clt2	Uploaded
I cooked μαγειρεύω	Μαγείρεψα	Clt2	Uploaded
I payed πληρώνω	Πλήρωσα	Clt2	Uploaded
I had έχω	Είχα	Clt2	Uploaded
I read διαβάζω	Διάβασα	Clt2	Uploaded
I was done τελειώνω	Τελείωσα	Clt2	Uploaded
I waited περιμένω	Περίμενα	Clt2	Uploaded
I took παίρνω	Πήρα	Clt2	Uploaded
I arrived φτάνω	Έφτασα	Clt2	Uploaded
Rule for past tense - tones - letters change	Tone on third last vowel * ζ > σ * ευ > εψ / φ > ψ * ν > σ	Clt2	Uploaded
The poem	Το ποίημα	Clt2	Uploaded
To book tickets	Κλείνω εισιτήρια	Clt2	Uploaded
The suitcase	Η βαλίτσα	Clt2	Uploaded
Continuously	Συνέχεια	Clt2	Uploaded
To decide	Αποφασίζω	Clt2	Uploaded
Literally: it has happened. It is done / het is in de sacoche.	Έγινε	Clt2	Uploaded
The moment	Η στιγμή	Clt2	Uploaded
I am closing off / I am letting you go (when stopping a conversation)	Σε κλείνω τώρα	Clt2	Uploaded
Against / according to / throughout	Κατά	Clt2	Uploaded
Around 09:00 (2 options)	Κατά τις 09:00 Γύρω στις 09:00	Clt2	Uploaded
We will see each other soon / See you soon (in person)	Τα λέμε από κοντά	Clt2	Uploaded
To do shopping	Ψωνίζω	Clt2	Uploaded
The nonsense 	Η σαχλαμάρα	Clt2	Uploaded
The performance / voorstelling	Η παράσταση	Clt2	Uploaded
Furious	Έξαλλος / η / ο	Clt2	Uploaded
The stripe	Η ρίγα / οι ρίγες	Clt2	Uploaded
The play / the opus / the work	Το έργο	Clt2	Uploaded
Put now into start / start off	Βάλτε μπρος	Clt2	Uploaded
The presentation	Η παρουσίαση	Clt2	Uploaded
The young woman	Η κοπέλα	Clt2	Uploaded
Future tense rules	Use the standard of the past tense Use the tone of the present tense Conjugate just like present tense	Clt2	Uploaded
The tragedy	Η τραγωδία	Clt2	Uploaded
The drama	Το δράμα	Clt2	Uploaded
The opera	Το όπερα	Clt2	Uploaded
To collect	Μαζεύω	Clt2	Uploaded
To be angry	Θυμώνω	Clt2	Uploaded
To turn on (electronic appliance, candle, lights,…)	Ανάβω το φως	Clt2	Uploaded
To turn off (electronic appliance, candle, lights,…)	Σβήνω το φως	Clt2	Uploaded
The light	Το φως	Clt2	Uploaded
To believe	Πιστεύω	Clt2	Uploaded
To write	Γράφω	Clt2	Uploaded
To steal	κλέβω	Clt2	Uploaded
Nowhere	Πουθενά	Clt2	Uploaded
Someone	Κάποιος	Clt2	Uploaded
To call on the phone	Παίρνω (στο) τηλέφωνο	Clt2	Uploaded
To change	Αλλάζω	Clt2	Uploaded
To clean	Καθαρίζω	Clt2	Uploaded
To iron	Σιδερώνω	Clt2	Uploaded
To have to … / il faut …	Πρέπει να ... Δουλέψω      	Clt2	Uploaded
Behind	Πίσω	Clt2	Uploaded
I want to … infinitif	Θέλω να … φάω	Clt2	Uploaded
πηγαίνω / πάω future tense	Πηγαίνω - πήγα - θα πάω	Clt2	Uploaded
βλέπω past future tense	Βλέπω - είδα - θα δω	Clt2	Uploaded
Παίρνω past and future tense	Παίρνω - πήρα - θα πάρω	Clt2	Uploaded
Λέω past and future tense	Λέω - είπα - θα πω	Clt2	Uploaded
Έχω past and future tense	Έχω - είχα - θα έχω	Clt2	Uploaded
Πίνω past and future tense	Πίνω - ήπια - θα πιω	Clt2	Uploaded
Καταλαβαίνω past and future tense	Καταλαβαίνω - κατάλαβα - θα καταλάβω	Clt2	Uploaded
Περιμένω past and future tense	Περιμένω - περίμενα - θα περιμένω	Clt2	Uploaded
Ahead / onward. Also used to pick up the phone: go ahead / on ward	Εμπρός	Clt2	Uploaded
Have fun!	Καλή διασκέδαση	Clt2	Uploaded